19
26
##########                
#........#                
#........#                
#........#                
#........#                
#........#                
#........#                
#........#                
#........#                
####*#####                
   #.#                    
   #.#  ##################
   #.####................#
   #.....................#
   ######................#
        #................#
        #................#
        #................#
        ##################