21
21
##########
#........#
#........#
#........#
#........#
#........#
#........#
#........#
#........#
####+#####
   #.#
   #.#  ##################
   #.####................#
   #.....................#
   ######................#
        #................#
		#................#
		#................#
		##################